UURRBBBBBBBBRRUU
EEBBXXXXXXXXBBEE
EEEBBXUUUUXBBEEE
EEEEBBXUUXBBEEEE
EEEEEBBXXBBEEEEE
EEEEEEBBBBEEEEEE
EEEEEEEBBEEEEEEE