EUUEEUUEEUUEEUUE
EXXEEXXEEXXEEXXE
BBBBBBBBBBBBBBBB
BBBBBBBBBBBBBBBB
BBBBBBRRRRBBBBBB
BBXXBBREERBBXXBB
BBBBBBREERBBBBBB