BBBBBBBBBBBBBBBB
RRRRRRRRRRRRRRRR
RXREEEEEEEEEERXR
RXREEEEEEEEEERXR
RXREEEEEEEEEERXR
RRRRRRBEERRRRRRR
BBBBBBBEEBBBBBBB